 #################                      
 #   #        #  #                      
 #   #        #  ##################     
 #   #        #            #      #     
 #   #        #            #      #     
 #   #######  #   ##########      #     
 #         #  #            #      #     
 #####################     #      #     
 #           #                    #     
 #           #                    #     
 #           #       #            #     
 #           #       #            #     
 #           #       #            #     
             #       #            #     
  ################   ###############    
                #            #######    
                #                       
                ##########$   